10 10 1 1 9<-------->
<        >
< - - -  >
< -   -  >
< - - -- >
< - -    >
< - - -- >
< -   -  >
<---- --->
<-------->
0
1
8 8
1
8 1 6 3 11 17 ; сундук
1
п
2 1
